{
  "levels": [
    {
      "id": "heist_01",
      "name": "The Vault",
      "terminal_door_links": [
        { "terminal": [11, 6], "door": [4, 10] },
        { "terminal": [4, 12], "door": [4, 14] }
      ],
      "map": [
        "WWWWWWWWWWWWWWWWWWWWWWWWW",
        "W.......................W",
        "W.........WWWWWWWWW.....W",
        "W.........W...W...W.....W",
        "W.........D.T.D.V.W.....W",
        "W.........W...W...W.....W",
        "W.........WWWWWWWWW.....W",
        "W.......................W",
        "W.......................W",
        "W.......................W",
        "W.......................W",
        "W.....T.................W",
        "W.......................W",
        "W.......................W",
        "W.......................W",
        "W.......................W",
        "W.......................W",
        "W.......................W",
        "WWWWWWWWWWWWWWWWWWWWWWWWW"
      ]
    },
    {
      "id": "heist_02",
      "name": "Server Room",
      "terminal_door_links": [
        { "terminal": [11, 3], "door": [4, 6] },
        { "terminal": [4, 8], "door": [4, 11] }
      ],
      "map": [
        "WWWWWWWWWWWWWWWWWWWWWWWWW",
        "W.......................W",
        "W.....WWWWWWWWWWWWWW....W",
        "W.....W....W.......W....W",
        "W.....D.T..D...V...W....W",
        "W.....W....W.......W....W",
        "W.....WWWWWWWWWWWWWW....W",
        "W.......................W",
        "W.......................W",
        "W.......................W",
        "W.......................W",
        "W..T....................W",
        "W.......................W",
        "W.......................W",
        "W.......................W",
        "W.......................W",
        "W.......................W",
        "W.......................W",
        "WWWWWWWWWWWWWWWWWWWWWWWWW"
      ]
    },
    {
      "id": "heist_03",
      "name": "Penthouse",
      "terminal_door_links": [
        { "terminal": [4, 3], "door": [9, 14] },
        { "terminal": [9, 11], "door": [11, 11] }
      ],
      "map": [
        "WWWWWWWWWWWWWWWWWWWWWWWWW",
        "W.......................W",
        "W.......................W",
        "W.......................W",
        "W..T....................W",
        "W.......................W",
        "W.......................W",
        "W.......WWWWWWWWWWWWW...W",
        "W.......W.....W.....W...W",
        "W.......W..T..D..V..W...W",
        "W.......W.....W.....W...W",
        "W.......WWWDWWWWWWWWW...W",
        "W.......................W",
        "W.......................W",
        "W.......................W",
        "W.......................W",
        "W.......................W",
        "W.......................W",
        "WWWWWWWWWWWWWWWWWWWWWWWWW"
      ]
    }
  ]
}
